NO assets/textures/42-cluster.xpm
SO assets/textures/42-gallery.xpm
WE assets/textures/42-window.xpm
EA assets/textures/42-42sp.xpm

F 218,218,218
C 28,13,120

11111111111
1G000000001
10000000001
10000000001
11111D11111
10000000001
10000000P01
11111100001
     100001
     100001
11111100001
10000000001
10000000001
10000111111
100001
100001
10000111111
10P00000001
10000000001
11111D11111
10000000001
10000N00001
10000000001
11111111111