WE assets/plant_wall.xpm

C 137, 207, 240
SO assets/plant_wall.xpm

NO assets/plant_wall.xpm



EA assets/plant_wall.xpm
F 79, 121, 66


11111111111111111111
10000010000000000001
10000010000000000001
10000010000000111101
10000000000000000101
10100010000000100101
10111111111100100101
10000000000100100001
10000000E00100110001
10000000000100010001
10011111100111110001
10010000000000000001
10011100001111111001
10010000001000000001
11111111111111111111