C 130,202,255
F 0,127,0

NO assets/texture.xpm
SO assets/texture.xpm
WE assets/texture.xpm
EA assets/texture.xpm

11111111111111
111111N1111111
11111111111111
