NO assets/astronaut1.xpm
SO assets/astronaut1.xpm
WE assets/astronaut1.xpm
EA assets/astronaut1.xpm

F 47,58,175
C 23,19,60

1111111111
10P0000001
1000000001
1000000001
1000000001
1000N00001
1000000001
100G000001
1000000001
1111111111