NO assets/texture.xpm
SO assets/texture.xpm
WE assets/texture.xpm
EA assets/texture.xpm

F 32,24,85
C 85,24,32

1111111111
10P0000001
1000000001
1000000001
1000000001
1000N00001
1000000001
1000000001
100P000001
1111111111