NO assets/textures/backgroundClouds.xpm
SO assets/textures/backgroundColorDesert.xpm
WE assets/textures/backgroundColorFall.xpm
EA assets/textures/backgroundColorForest.xpm

F 255,233,183
C 171,219,227

11111111111
10000000001
11111D11111
10000000001
10000000001
10000N00001
10000000001
11111D11111
10000000001
11111111111
