NO assets/textures/backgroundClouds.xpm
SO assets/textures/backgroundColorDesert.xpm
WE assets/textures/backgroundColorFall.xpm
EA assets/textures/backgroundColorForest.xpm

F 255,233,183
C 171,219,227

1111111111111111111111111111
1E00000000000000000000000001
1000000000000000000000000001
1000000000000000000000000001
1111111111111111111D11111111
                  100000001
                 100000001
                100000001
               100000001
              100000001
             100000001
            100000001
           100000001
          100000001
         100000001
        100000001
       100000001
      100000001
     100000001
    100000001
   100000001
  100000001
 100000001
100000001
1111111D11111111111111111111
1000000000000000000000000001
1000000000000000000000000001
1000000000000000000000000001
1111111111111111111111111111