NO assets/textures/texture.xpm
EA assets/textures/texture.xpm
SO assets/textures/texture.xpm
WE assets/textures/texture.xpm

C 35,19,73
F 15,6,40

111111111111111
111111000111111
111110000011111
111100000001111
111000000000111
110000000000011
100000000000001
110000111000011
111000010001111
1111000000  111
1111100S00  011
111111000000111
111111111111111