NO assets/textures/texture.xpm
SO assets/textures/texture.xpm
WE assets/textures/texture.xpm
EA assets/textures/texture.xpm

F 220,100,0
C 225,30,0

        1111111111111111111111111
        1000000000110000000000001
        1011000001110000000000001
        1001000000000000000000001
        1111111110110000011100001
000000000011000001110111111111111
11110111111111011100000010001
11110111111111011101010010001
11000000110101011100000010001
10000000000000001100000010001
10000000000000001101010010001
11000001110101011111011110001
11110111 1110101 101111010N01
11111111 1111111 111111111111